WWWWWWWWWWWWW
WGCCCSDDDDDDW
WDDDDDDDDDDDW
WCDCWCDCCCWDW
WDDDWDWDDDWDW
WCDDDDWDDDDDW
WDDDWDWDDDWDW
WCDCCCDCCCWDW
WCWCWDWDWCWDW
WDWDDDDDDDDDW
WWWWWWWWWWWWW