WWWWWWWWWWWWW
WCCCCCCCCCCCW
WCCCCCCCCGCCW
WCCCCDDCCCCCW
WCCCDCCDCCCCW
WCCCCCDCCCCCW
WCCCCDCCCCCCW
WCSCDDDDCCCCW
WCCCCCCCCCCCW
WWWWWWWWWWWWW