WWWWWWWWWWWWW
WCCCCCCCCCCCW
WCCCCCDCCGCCW
WCCCCDDCCCCCW
WCCCDDDCCCCCW
WCCCCCDCCCCCW
WCCCCCDCCCCCW
WCSCCCDCCCCCW
WCCCCCCCCCCCW
WWWWWWWWWWWWW