WWWWWWWWWWWWW
WCDDDDDDDDDCW
WCWWWWWWWWWCW
WCDDDDGDDDDCW
WCWWWWWWWWWCW
TCDDDDDDDDDCT
WCWWWWWWWWWCW
WCDDDDDDDDDCW
WCWWWWWWWWWCW
WDDDDDSDDDDDW
WWWWWWWWWWWWW