WWWWWWWWWWWWW
WGDDDDWDDDWDW
WCDCDDWDDCWCW
TCDCCCWCCCWCT
WDDWWDWDDDWDW
TCDDDDWDDDDCT
WDDWWDWDDDWDW
TCDCCCWCCCWCT
WCDCDDWDDCWCW
WSDDDDWDDDWDW
WWWWWWWWWWWWW