WWWWWWWWWWWWW
WCCCCCCCCCCCW
WCCCCDDCCGCCW
WCCCDCCDCCCCW
WCCCCCDCCCCCW
WCCCDCCDCCCCW
WCCCCDDCCCCCW
WCSCCCCCCCCCW
WCCCCCCCCCCCW
WWWWWWWWWWWWW