WWWWWWWWWWWWW
WDDDDDDDDDDDW
WCWCWWCWWCWCW
WCWCCCCCCCWCW
WDDDWWCWWDDDW
TCWCCCGCCCWCT
WDDDWWWWWDDDW
WCWCCCSCCCWCW
WCWCWWDWWCWCW
WDDDDDDDDDDDW
WWWWWWWWWWWWW